this page lists living orders and families of birds the links below should then lead to family accounts and hence to individual species
taxonomy is very fluid in the age of dna analysis so comments are made where appropriate and all numbers are approximate in particular see sibley-ahlquist taxonomy for a very different classification
== phylogeny ==
cladogram of modern bird relationships based on jarvis e.d et al (2014) with some clade names after yury t et al (2013)
== paleognathae ==
the flightless and mostly giant struthioniformes lack a keeled sternum and are collectively known as ratites together with the tinamiformes they form the paleognathae or "old jaws" one of the two evolutionary superorders
=== struthioniformes ===
africa; 2 species
struthionidae: ostrich
=== notopalaeognathae ===
==== rheiformes ====
south america; 2 species
rheidae: rheas
==== tinamiformes ====
south america; 45 species
tinamidae: tinamous
==== novaeratitae ====
===== casuariiformes =====
australasia; 4 species
casuariidae: cassowaries
dromaiidae: emu
===== apterygiformes =====
australasia; 5 species
apterygidae: kiwis
== neognathae ==
nearly all living birds belong to the superorder of neognathae or "new jaws" with their keels unlike the ratites they are known as carinatae the passerines alone account for well over 5000 species in total there are almost 8640 species of birds worldwide
=== galloanserae ===
==== anseriformes ====
worldwide; 150 species
anhimidae: screamers
anseranatidae: magpie-goose
anatidae: ducks geese and swans
==== order galliformes ====
worldwide; 250 species
megapodidae: megapodes
cracidae: chachalacas curassows and guans
phasianoidea: pheasants and allies
odontophoridae: new world quail
numididae: guineafowl
phasianidae: pheasants and relatives
=== neoaves ===
==== columbea ====
===== mirandornithes =====
====== podicipediformes ======
worldwide; 19 species
podicipedidae: grebes
====== phoenicopteriformes ======
worldwide; 6 species
phoenicopteridae: flamingos
===== columbimorphae =====
====== columbiformes ======
worldwide; 300 species
columbidae: pigeons and doves
====== pteroclidiformes ======
africa europe asia; 16 species
pteroclididae: sandgrouse
====== mesitornithiformes ======
madagascar; 3 species
mesitornithidae: mesites
==== passerea ====
===== caprimulgiformes =====
worldwide; 500 species
steatornithidae: oilbird
podargidae: frogmouths
nyctibiidae: potoos
caprimulgidae: nightjars
aegothelidae: owlet-nightjars
trochilidae: hummingbirds
apodidae: swifts
hemiprocnidae: treeswifts
===== otidimorphae =====
====== cuculiformes ======
worldwide; 126 species
cuculidae: cuckoos and relatives
====== musophagiformes ======
africa; 23 species
musophagidae: turacos and relatives
====== otidiformes ======
africa and eurasia; 27 species
otididae: bustards
===== opisthocomiformes =====
south america; 1 species
opisthocomidae: hoatzin
===== cursorimorphae =====
====== gruiformes ======
worldwide; 164 species
grui: cranes and allies
gruidae: cranes
aramidae: limpkin
psophiidae: trumpeters
ralli: rails and allies
rallidae: rails and relatives
sarothruridae flufftails
heliornithidae: finfoots
====== charadriiformes ======
worldwide; 350 species
scolopaci
scolopacidae: sandpipers and relatives
thinocori: jacana-like waders
rostratulidae: painted snipes
pluvianidae: egyptian plover
jacanidae: jacanas
thinocoridae: seedsnipes
pedionomidae: plains-wanderer
turnici
turnicidae: buttonquail
lari: gulls and allies
laridae: gulls
rhynchopidae: skimmers
sternidae: terns
alcidae: auks
stercorariidae: skuas and jaegers
glareolidae: coursers and pratincoles
dromadidae: crab-plover
chionidi: thick-knees and allies
burhinidae: thick-knees and relatives
chionididae: sheathbills
pluvianellidae: magellanic plover
charadrii: plover-like waders
ibidorhynchidae: ibisbill
recurvirostridae: avocets and stilts
haematopodidae: oystercatchers
charadriidae: plovers and lapwings
=== eurypygiformes ===
neotropics and new caledonia; 2 species
rhynochetidae: kagu
eurypygidae: sunbittern
=== phaethontiformes ===
oceanic; 3 species
phaethontidae: tropicbirds
=== gaviiformes ===
north america eurasia; 5 species
gaviidae: loons
=== sphenisciformes ===
antarctic and southern waters; 17 species
spheniscidae: penguins
=== procellariiformes ===
pan-oceanic; 120 species
diomedeidae: albatrosses
procellariidae: petrels and relatives
pelecanoididae: diving petrels
hydrobatidae: storm petrels
=== ciconiiformes ===
worldwide; 19 species
ciconiidae: storks
=== pelecaniformes ===
worldwide; 108 species
balaenicipitidae: shoebill
scopidae: hamerkop
pelecanidae: pelicans
ardeidae: herons and relatives
threskiornithidae: ibises and spoonbills
=== suliformes ===
worldwide; 59 species
phalacrocoracidae: cormorants and shags
fregatidae: frigatebirds
sulidae: boobies and gannets
anhingidae: darters
=== accipitriformes ===
worldwide; 200 species
cathartidae: new world vultures
pandionidae: osprey
accipitridae: hawks eagles buzzards harriers kites and old world vultures
sagittaridae: secretarybird
=== strigiformes ===
worldwide; 130 species
tytonidae: barn owls
strigidae: true owls
=== coliiformes ===
sub-saharan africa; 6 species
coliidae: mousebirds
=== trogoniformes ===
sub-saharan africa americas asia; 35 species
trogonidae: trogons and quetzals
=== coraciiformes ===
worldwide; 144 species
meropidae: bee-eaters
coraciidae: rollers
brachypteraciidae: ground rollers
todidae: todies
momotidae: motmots
alcedines: kingfishers
alcedinidae: river kingfishers
halcyonidae: tree kingfishers
cerylidae: water kingfishers
=== bucerotiformes ===
old world new guinea; 64 species
bucerotidae: hornbills
upupidae: hoopoe
phoeniculidae: woodhoopoes
=== leptosomatiformes ===
madagascar; 1 species
leptosomatidae: cuckoo-roller
=== piciformes ===
worldwide except australasia; 400 species
galbulidae: jacamars
bucconidae: puffbirds
lybiidae: african barbets
megalaimidae: asian barbets
ramphastidae: toucans
semnornithidae: toucan barbets
capitonidae: american barbets
picidae: woodpeckers
indicatoridae: honeyguides
=== cariamiformes ===
south america; 2 species
cariamidae: seriemas
=== falconiformes ===
worldwide; 60 species
falconidae: falcons and relatives
=== psittaciformes ===
pan-tropical southern temperate zones; 330 species
nestoridae: kea and kakas
strigopidae: kakapo
cacatuidae: cockatoos
psittacidae: african and american parrots
psittrichasiidae: pesquet's parrot vasa parrots
psittaculidae: australasian parrots
=== passeriformes ===
worldwide; 5000 species
acanthisitti
acanthisittidae: new zealand wrens
tyranni: suboscines
eurylaimidae: broadbills
philepittidae: asities
pittidae: pittas
sapayoidae: sapayoa
tyrannidae: tyrant flycatchers
tityridae: becards and tityras
furnariidae: ovenbirds
thamnophilidae: antbirds
formicariidae: ground antbirds
rhinocryptidae tapaculos
grallariidae: antpittas
conopophagidae: gnateaters
cotingidae: cotingas
pipridae: manakins
melanopareiidae: crescent-chests
passeri: oscines
atrichornithidae: scrub-birds
menuridae: lyrebirds
alaudidae: larks
hirundinidae: swallows and martins
motacillidae: wagtails and pipits
campephagidae: cuckoo-shrikes
eupetidae: rail-babbler
pycnonotidae: bulbuls
regulidae: kinglets
hyliotidae: hyliotas
chloropseidae: leafbirds
aegithinidae: ioras
ptilogonatidae: silky-flycatchers
bombycillidae: waxwings
hypocoliidae: hypocolius
dulidae: palmchat
cinclidae: dippers
troglodytidae: wrens
donacobiidae: donacobius
mimidae: mockingbirds and thrashers
prunellidae: accentors
turdidae: thrushes and relatives
cisticolidae: cisticolas and relatives
sylviidae: true warblers
stenostiridae: fairy warblers
macrosphenidae: african warblers
cettiidae: bush warblers
phylloscopidae: leaf warblers
megaluridae: grass warblers
acrocephalidae: marsh warblers
bernieridae: malagasy warblers
pnoepygidae: pygmy wren-babblers
polioptilidae: gnatcatchers
muscicapidae: flycatchers and relatives
platysteiridae: wattle-eyes and batises
petroicidae: australasian robins
pachycephalidae: whistlers and relatives
colluricinclidae: shrike-thrushes and relatives
picathartidae: rockfowl
chaetopidae: rock-jumpers
timaliidae: babblers and relatives
panuridae: bearded reedling
nicatoridae: nicators
pomatostomidae: australasian babblers
orthonychidae: logrunners
cinclosomatidae: whipbirds and quail-thrushes
aegithalidae: bushtits
maluridae: australasian wrens
neosittidae: sittellas
climacteridae: australasian treecreepers
paridae: chickadees and true tits
sittidae: nuthatches
tichodromidae: wallcreeper
certhiidae: treecreepers
rhabdornithidae: philippine creepers
remizidae: penduline tits
nectariniidae: sunbirds
melanocharitidae: berrypeckers
paramythiidae: painted berrypeckers
dicaeidae: flowerpeckers
dasyornithidae: bristlebirds
pardalotidae: pardalotes
acanthizidae: australasian warblers
zosteropidae: white-eyes
promeropidae: sugarbirds
meliphagidae: honeyeaters and relatives
notiomystidae: stitchbird
oriolidae: old world orioles
irenidae: fairy-bluebirds
laniidae: shrikes
malaconotidae: bushshrikes and relatives
prionopidae: helmetshrikes and relatives
vangidae: vangas
dicruridae: drongos
rhipiduridae: fantails
monarchidae: monarch flycatchers
callaeidae: wattlebirds
corcoracidae: mudnesters
artamidae: woodswallows and butcherbirds
pityriaseidae: bristlehead
paradisaeidae: birds-of-paradise
cnemophilidae: satinbirds
ptilonorhynchidae: bowerbirds
corvidae: jays and crows
sturnidae: starlings and mynas
buphagidae: oxpeckers
passeridae: old world sparrows
ploceidae: weavers and relatives
estrildidae: weaver finches
viduidae: whydahs and indigobirds
vireonidae: vireos and relatives
fringillidae: finches and relatives
urocynchramidae: pink-tailed bunting
peucedramidae: olive warbler
parulidae: wood warblers
coerebidae: bananaquit
thraupidae: tanagers and relatives
emberizidae: old world buntings and new world sparrows
cardinalidae: cardinals grosbeaks and new world buntings
icteridae: new world blackbirds and new world orioles
== simplified classification ==
struthioniformes ostriches emus kiwis and allies
tinamiformes tinamous
anseriformes waterfowl
galliformes fowl
charadriiformes waders gulls and auks
gaviiformes loons
podicipediformes grebes
procellariformes albatrosses petrels and allies
sphenisciformes penguins
pelecaniformes pelicans and allies
phaethontiformes tropicbirds
ciconiiformes storks and allies
phoenicopteriformes flamingos
falconiformes hawks falcons old world vultures and allies
gruiformes cranes and allies
pteroclidiformes sangrouse
columbiformes pigeons and doves
psittaciformes parrots
cuculiformes cuckoos and allies
opisthocomiformes hoatzin
strigiformes owls
caprimulgiformes nightjars frogmouths and allies
apodiformes swifts and hummingbirds
coraciiformes kingfishers and allies
piciformes woodpeckers and allies
trogoniformes trogons
coliiformes mousebirds
passeriformes passerines
== see also ==
lists of animals
list of birds of the world
list of african birds
list of asian birds
list of birds of australia new zealand and antarctica
list of australian birds
list of european birds
list of north american birds
list of extinct birds
prehistoric birds
fossil birds
list of chicken breeds
list of birds by common name
list of historical and fictional birds
for regions smaller than continents see:
lists of birds by region
== references ==
